"filename", "language", "C++", "Markdown", "TXT", "comment", "blank", "total"
"e:\project-C++\DATA_Struct\LinearDataStructure\FactorySimulation.cpp", "C++", 0, 0, 0, 278, 0, 278
"e:\project-C++\DATA_Struct\LinearDataStructure\QueueApp.cpp", "C++", -325, 0, 0, 325, 0, 0
"e:\project-C++\DATA_Struct\LinearDataStructure\StackApp.cpp", "C++", 206, 0, 0, -206, 0, 0
"e:\project-C++\DATA_Struct\LinearDataStructure\arrayList.hpp", "C++", 1, 0, 0, 0, 0, 1
"e:\project-C++\DATA_Struct\LinearDataStructure\linkedStack.hpp", "C++", 0, 0, 0, 1, 0, 1
"e:\project-C++\DATA_Struct\README.md", "Markdown", 0, 1, 0, 0, 1, 2
"e:\project-C++\DATA_Struct\SortAlgrithm\MySort.h", "C++", 0, 0, 0, 10, 0, 10
"e:\project-C++\DATA_Struct\TreeStructure\Signal_amplifier.cpp", "C++", 0, 0, 0, 106, 1, 107
"e:\project-C++\DATA_Struct\TreeStructure\binaryTree.hpp", "C++", 15, 0, 0, 0, 0, 15
"e:\project-C++\DATA_Struct\TreeStructure\findUnion.cpp", "C++", 0, 0, 0, 95, 1, 96
"e:\project-C++\DATA_Struct\TreeStructure\linkedBinaryTree.hpp", "C++", 382, 0, 0, 12, 8, 402
"e:\project-C++\DATA_Struct\TreeStructure\linkedPriorityQueue.hpp", "C++", 54, 0, 0, 0, 0, 54
"e:\project-C++\DATA_Struct\TreeStructure\main.cpp", "C++", 62, 0, 0, 26, 1, 89
"e:\project-C++\DATA_Struct\TreeStructure\maxPriorityQueue.hpp", "C++", 14, 0, 0, 0, 0, 14
"e:\project-C++\DATA_Struct\TreeStructure\setTree.hpp", "C++", 44, 0, 0, 5, 1, 50
"e:\project-C++\DATA_Struct\TreeStructure\sortedChain.hpp", "C++", 249, 0, 0, 0, 4, 253
"e:\project-C++\DATA_Struct\mapDictionary\LZWcompress.cpp", "C++", 95, 0, 0, 38, 1, 134
"e:\project-C++\DATA_Struct\mapDictionary\LZWdecompress.cpp", "C++", 101, 0, 0, 29, 0, 130
"e:\project-C++\DATA_Struct\mapDictionary\Main.cpp", "C++", 0, 0, 0, 152, 1, 153
"e:\project-C++\DATA_Struct\mapDictionary\codeFile.txt", "TXT", 0, 0, 1, 0, 0, 1
"e:\project-C++\DATA_Struct\mapDictionary\decodeFile.txt", "TXT", 0, 0, 1, 0, 0, 1
"e:\project-C++\DATA_Struct\mapDictionary\dictionary.hpp", "C++", 16, 0, 0, 0, 0, 16
"e:\project-C++\DATA_Struct\mapDictionary\hashChain.hpp", "C++", 182, 0, 0, 1, 1, 184
"e:\project-C++\DATA_Struct\mapDictionary\hashMapTest.cpp", "C++", 24, 0, 0, 3, 1, 28
"e:\project-C++\DATA_Struct\mapDictionary\hashTable.hpp", "C++", 137, 0, 0, 13, 1, 151
"e:\project-C++\DATA_Struct\mapDictionary\skipList.cpp", "C++", 108, 0, 0, 9, 2, 119
"e:\project-C++\DATA_Struct\mapDictionary\sortedChain.hpp", "C++", 223, 0, 0, 0, 3, 226
"e:\project-C++\DATA_Struct\test.cpp", "C++", 0, 0, 0, 10, 1, 11
"Total", "-", 1588, 1, 2, 907, 28, 2526