"filename", "language", "TXT", "C++", "CSV", "comment", "blank", "total"
"c:\Users\Administrator\Desktop\project-C++\DATA_Struct\0_intruduce\Example.h", "C++", 0, -133, 0, -12, -2, -147
"c:\Users\Administrator\Desktop\project-C++\DATA_Struct\0_intruduce\GCD.cpp", "C++", 0, 0, 0, -49, -1, -50
"c:\Users\Administrator\Desktop\project-C++\DATA_Struct\0_intruduce\MaxSubsum.cpp", "C++", 0, 0, 0, -289, -7, -296
"c:\Users\Administrator\Desktop\project-C++\DATA_Struct\0_intruduce\test0.cpp", "C++", 0, -43, 0, -41, -5, -89
"c:\Users\Administrator\Desktop\project-C++\DATA_Struct\0_intruduce\test02.cpp", "C++", 0, 0, 0, -75, -4, -79
"c:\Users\Administrator\Desktop\project-C++\DATA_Struct\0_intruduce\test1.cpp", "C++", 0, 0, 0, -58, -2, -60
"c:\Users\Administrator\Desktop\project-C++\DATA_Struct\0_intruduce\undo.cpp", "C++", 0, 0, 0, -187, 0, -187
"c:\Users\Administrator\Desktop\project-C++\DATA_Struct\LinearDataStructure\MatrixTestMain.cpp", "C++", 0, 0, 0, -127, 0, -127
"c:\Users\Administrator\Desktop\project-C++\DATA_Struct\LinearDataStructure\applycation.cpp", "C++", 0, 0, 0, -160, -2, -162
"c:\Users\Administrator\Desktop\project-C++\DATA_Struct\LinearDataStructure\arrayList.hpp", "C++", 0, -360, 0, -6, -2, -368
"c:\Users\Administrator\Desktop\project-C++\DATA_Struct\LinearDataStructure\arrayStack.hpp", "C++", 0, -131, 0, -2, -1, -134
"c:\Users\Administrator\Desktop\project-C++\DATA_Struct\LinearDataStructure\chainList.hpp", "C++", 0, -709, 0, -38, -3, -750
"c:\Users\Administrator\Desktop\project-C++\DATA_Struct\LinearDataStructure\circularList.hpp", "C++", 0, -263, 0, -8, -2, -273
"c:\Users\Administrator\Desktop\project-C++\DATA_Struct\LinearDataStructure\doubleLinkList.hpp", "C++", 0, -507, 0, -25, -2, -534
"c:\Users\Administrator\Desktop\project-C++\DATA_Struct\LinearDataStructure\linearList.hpp", "C++", 0, -50, 0, 0, 0, -50
"c:\Users\Administrator\Desktop\project-C++\DATA_Struct\LinearDataStructure\linearListMain.cpp", "C++", 0, 0, 0, -410, 0, -410
"c:\Users\Administrator\Desktop\project-C++\DATA_Struct\LinearDataStructure\linkedStack.hpp", "C++", 0, -143, 0, 0, -1, -144
"c:\Users\Administrator\Desktop\project-C++\DATA_Struct\LinearDataStructure\listLearning.cpp", "C++", 0, 0, 0, -126, -3, -129
"c:\Users\Administrator\Desktop\project-C++\DATA_Struct\LinearDataStructure\matrix.hpp", "C++", 0, -341, 0, -6, -4, -351
"c:\Users\Administrator\Desktop\project-C++\DATA_Struct\LinearDataStructure\myExpectation.h", "C++", 0, -103, 0, -10, -10, -123
"c:\Users\Administrator\Desktop\project-C++\DATA_Struct\LinearDataStructure\polynomial.hpp", "C++", 0, -520, 0, -3, -4, -527
"c:\Users\Administrator\Desktop\project-C++\DATA_Struct\LinearDataStructure\stackTestMain.cpp", "C++", 0, -59, 0, -2, -1, -62
"c:\Users\Administrator\Desktop\project-C++\DATA_Struct\MaxSub.csv", "CSV", 0, 0, -20, 0, -1, -21
"c:\Users\Administrator\Desktop\project-C++\DATA_Struct\SortAlgrithm\MySort.h", "C++", 0, -178, 0, -50, -6, -234
"c:\Users\Administrator\Desktop\project-C++\DATA_Struct\SortAlgrithm\test1.cpp", "C++", 0, -36, 0, -9, -1, -46
"c:\Users\Administrator\Desktop\project-C++\DATA_Struct\myExpectation.h", "C++", 0, -103, 0, -10, -10, -123
"c:\Users\Administrator\Desktop\project-C++\DATA_Struct\undo.txt", "TXT", -9, 0, 0, 0, -1, -10
"c:\Users\Administrator\Desktop\project-C++\DATA_Struct\undo1.txt", "TXT", -9, 0, 0, 0, -1, -10
"c:\Users\Administrator\Desktop\project-C++\DATA_Struct\undo2.txt", "TXT", -9, 0, 0, 0, -2, -11
"e:\project-C++\DATA_Struct\0_intruduce\Example.h", "C++", 0, 133, 0, 12, 2, 147
"e:\project-C++\DATA_Struct\0_intruduce\GCD.cpp", "C++", 0, 0, 0, 49, 1, 50
"e:\project-C++\DATA_Struct\0_intruduce\MaxSubsum.cpp", "C++", 0, 0, 0, 289, 7, 296
"e:\project-C++\DATA_Struct\0_intruduce\test0.cpp", "C++", 0, 0, 0, 84, 5, 89
"e:\project-C++\DATA_Struct\0_intruduce\test02.cpp", "C++", 0, 0, 0, 75, 4, 79
"e:\project-C++\DATA_Struct\0_intruduce\test1.cpp", "C++", 0, 0, 0, 58, 2, 60
"e:\project-C++\DATA_Struct\0_intruduce\undo.cpp", "C++", 0, 228, 0, 12, 3, 243
"e:\project-C++\DATA_Struct\LinearDataStructure\FactorySimulation.cpp", "C++", 0, 0, 0, 0, 1, 1
"e:\project-C++\DATA_Struct\LinearDataStructure\MatrixTestMain.cpp", "C++", 0, 0, 0, 127, 0, 127
"e:\project-C++\DATA_Struct\LinearDataStructure\QueueApp.cpp", "C++", 0, 325, 0, 21, 5, 351
"e:\project-C++\DATA_Struct\LinearDataStructure\StackApp.cpp", "C++", 0, 0, 0, 237, 4, 241
"e:\project-C++\DATA_Struct\LinearDataStructure\arrayDeque.hpp", "C++", 0, 269, 0, 10, 4, 283
"e:\project-C++\DATA_Struct\LinearDataStructure\arrayList.hpp", "C++", 0, 359, 0, 6, 4, 369
"e:\project-C++\DATA_Struct\LinearDataStructure\arrayQueue.hpp", "C++", 0, 126, 0, 2, 2, 130
"e:\project-C++\DATA_Struct\LinearDataStructure\arrayStack.hpp", "C++", 0, 131, 0, 2, 1, 134
"e:\project-C++\DATA_Struct\LinearDataStructure\chainList.hpp", "C++", 0, 709, 0, 38, 3, 750
"e:\project-C++\DATA_Struct\LinearDataStructure\circularList.hpp", "C++", 0, 263, 0, 8, 2, 273
"e:\project-C++\DATA_Struct\LinearDataStructure\deque.hpp", "C++", 0, 19, 0, 0, 0, 19
"e:\project-C++\DATA_Struct\LinearDataStructure\doubleLinkList.hpp", "C++", 0, 544, 0, 25, 2, 571
"e:\project-C++\DATA_Struct\LinearDataStructure\linearList.hpp", "C++", 0, 50, 0, 0, 0, 50
"e:\project-C++\DATA_Struct\LinearDataStructure\linearListMain.cpp", "C++", 0, 0, 0, 410, 0, 410
"e:\project-C++\DATA_Struct\LinearDataStructure\linkedQueue.hpp", "C++", 0, 145, 0, 0, 1, 146
"e:\project-C++\DATA_Struct\LinearDataStructure\linkedStack.hpp", "C++", 0, 197, 0, 0, 1, 198
"e:\project-C++\DATA_Struct\LinearDataStructure\listLearning.cpp", "C++", 0, 0, 0, 126, 3, 129
"e:\project-C++\DATA_Struct\LinearDataStructure\matrix.hpp", "C++", 0, 341, 0, 6, 4, 351
"e:\project-C++\DATA_Struct\LinearDataStructure\myExpectation.h", "C++", 0, 103, 0, 10, 10, 123
"e:\project-C++\DATA_Struct\LinearDataStructure\polynomial.hpp", "C++", 0, 520, 0, 3, 4, 527
"e:\project-C++\DATA_Struct\LinearDataStructure\queue.hpp", "C++", 0, 17, 0, 0, 0, 17
"e:\project-C++\DATA_Struct\LinearDataStructure\queueTestMain.cpp", "C++", 0, 0, 0, 112, 1, 113
"e:\project-C++\DATA_Struct\LinearDataStructure\ratMaze.cpp", "C++", 0, 0, 0, 157, 0, 157
"e:\project-C++\DATA_Struct\LinearDataStructure\stackTestMain.cpp", "C++", 0, 0, 0, 325, 1, 326
"e:\project-C++\DATA_Struct\MaxSub.csv", "CSV", 0, 0, 20, 0, 1, 21
"e:\project-C++\DATA_Struct\SortAlgrithm\MySort.h", "C++", 0, 178, 0, 50, 6, 234
"e:\project-C++\DATA_Struct\SortAlgrithm\test1.cpp", "C++", 0, 36, 0, 9, 1, 46
"e:\project-C++\DATA_Struct\data1.txt", "TXT", 7, 0, 0, 0, 0, 7
"e:\project-C++\DATA_Struct\data2.txt", "TXT", 7, 0, 0, 0, 0, 7
"e:\project-C++\DATA_Struct\myExpectation.h", "C++", 0, 103, 0, 10, 10, 123
"e:\project-C++\DATA_Struct\undo.txt", "TXT", 9, 0, 0, 0, 1, 10
"e:\project-C++\DATA_Struct\undo1.txt", "TXT", 9, 0, 0, 0, 1, 10
"e:\project-C++\DATA_Struct\undo2.txt", "TXT", 9, 0, 0, 0, 2, 11
"e:\project-C++\DATA_Struct\undo3.txt", "TXT", 9, 0, 0, 0, 0, 9
"Total", "-", 23, 1117, 0, 570, 21, 1731